# Brian
# cleaned, ordered, supplemented
# IDs sorted numerically (duh)
#
# preserve the order
# do NOT remove final spaces in ID lists
#
# climate assignment to do:
# 4846--4869 in Australia
# 4871--4889, 4891, 4894--4919, 4921, 4922, 4923 in N.A.
# 4937, 4938, 4939 in Oceania
# 6001--6041 in Anatolia

tropical = { # 922
	482 483 484 485 486 487 488 489 490 492 493 494 495 496 497 498 499 500 501 502 516 517 526 527 529 530 531 533 534 535 537 539 540 542 543 544 545 546 547 548 549 552 553 561 564 567 568 570 572 573 574 579 580 581 582 583 584 585 586 587 588 589 590 591 592 593 594 595 596 597 598 599 600 601 602 603 604 605 606 607 608 609 610 611 612 613 614 615 616 617 618 619 620 621 622 623 624 625 626 627 628 629 630 631 632 633 634 635 636 637 638 639 640 641 642 643 644 645 646 647 648 649 650 651 652 653 654 655 656 657 658 659 660 663 664 666 738 741 742 743 744 745 746 747 748 749 752 756 757 758 759 760 761 765 766 768 769 776 788 789 798 799 800 801 803 815 818 821 822 826 828 829 830 831 834 835 836 837 838 839 840 841 842 843 845 846 1016 1022 1113 1114 1116 1117 1118 1119 1120 1121 1122 1123 1124 1125 1126 1134 1135 1136 1137 1138 1139 1140 1141 1142 1143 1144 1145 1146 1147 1149 1150 1151 1152 1153 1154 1155 1160 1161 1162 1163 1164 1165 1166 1167 1168 1169 1170 1171 1172 1182 1183 1184 1185 1186 1187 1188 1189 1190 1191 1192 1194 1195 1196 1197 1198 1199 1200 1201 1202 1218 1235 1236 1237 1238 1239 1240 1241 1242 1243 1244 1245 1249 1789 1792 1796 1797 1798 1799 1800 1802 1803 1815 1817 1823 1844 1881 1901 1946 1947 1986 1987 1988 1989 1990 1991 1992 1993 1994 1995 1996 1997 1998 1999 2026 2028 2029 2030 2033 2034 2036 2037 2038 2039 2041 2043 2048 2049 2050 2057 2080 2081 2083 2084 2089 2090 2091 2092 2099 2100 2154 2155 2159 2160 2161 2162 2163 2164 2165 2166 2237 2238 2239 2240 2241 2242 2245 2248 2249 2250 2252 2253 2254 2255 2256 2257 2258 2266 2267 2270 2278 2280 2281 2283 2285 2286 2289 2290 2291 2292 2293 2294 2295 2371 2372 2373 2374 2375 2376 2377 2378 2379 2380 2381 2382 2383 2384 2385 2386 2387 2388 2389 2390 2391 2392 2393 2394 2395 2396 2397 2398 2399 2400 2401 2402 2403 2404 2536 2633 2634 2635 2636 2637 2638 2640 2649 2650 2651 2652 2653 2654 2655 2656 2658 2659 2660 2661 2662 2663 2664 2673 2674 2675 2676 2677 2678 2679 2680 2681 2682 2683 2684 2685 2686 2687 2688 2689 2690 2691 2692 2693 2695 2696 2697 2698 2699 2700 2701 2702 2703 2704 2705 2706 2707 2708 2709 2710 2711 2712 2713 2714 2715 2716 2717 2718 2719 2720 2721 2722 2723 2724 2725 2728 2729 2730 2731 2740 2756 2757 2759 2803 2804 2805 2806 2807 2808 2809 2810 2811 2812 2813 2814 2815 2816 2819 2823 2830 2832 2833 2834 2881 2882 2886 2887 2888 2889 2890 2891 2892 2893 2894 2895 2896 2897 2898 2899 2900 2901 2902 2903 2904 2905 2906 2907 2908 2909 2910 2911 2914 2916 2919 2920 2923 2924 2925 2926 2927 2928 2929 2930 2931 2933 2934 2935 2937 2938 2939 2943 2944 2945 2948 2949 2950 2951 2952 4021 4022 4023 4024 4025 4026 4027 4029 4030 4031 4034 4035 4036 4037 4038 4039 4040 4041 4042 4043 4044 4045 4046 4047 4048 4049 4050 4053 4054 4058 4059 4060 4061 4062 4063 4064 4065 4066 4067 4068 4069 4070 4071 4072 4074 4075 4076 4077 4078 4079 4080 4081 4082 4083 4084 4085 4086 4087 4088 4089 4090 4091 4092 4093 4094 4095 4096 4097 4098 4099 4100 4101 4102 4103 4104 4105 4106 4107 4108 4109 4348 4349 4350 4351 4352 4353 4354 4355 4356 4393 4394 4395 4396 4397 4398 4399 4404 4405 4406 4407 4408 4409 4410 4413 4415 4416 4417 4418 4419 4425 4427 4429 4430 4431 4432 4433 4439 4441 4442 4443 4444 4445 4446 4448 4450 4451 4460 4473 4474 4475 4476 4477 4478 4585 4586 4587 4589 4592 4593 4594 4595 4597 4601 4602 4608 4609 4610 4611 4612 4613 4614 4615 4616 4617 4618 4619 4620 4621 4622 4623 4624 4790 4791 4792 4793 4794 4795 4796 4797 4798 4799 4800 4801 4802 4803 4804 4805 4806 4808 4809 4810 4811 4812 4813 4814 4815 4816 4817 4818 4819 4820 4821 4822 4823 4824 4825 4826 4827 4828 4829 4830 4831 4832 4833 4834 4835 4836 4837 4838 4839 4840 4841 4842 4844 4845 4870 4934 4935 4936 5023 5024 5025 5026 5382 5563 5565 5567 5572 5574 5575 5576 5577 5578 5579 5581 5582 5583 5584 5585 5586 8544 8546 8547 8548 8549 8551 8552 8553 8554 8555 8559 8561 8565 8569 8571 8572 8573 8576 8577 8578 8580 8581 8584 8585 8587 8592 8593 8597 8598 8600 8602 8603 8604 8606 8614 8615 8616 8618 8619 8623 8624 8625 8627 8630 8631 8632 8633 8634 8635 8636 8639 8640 8641 8642 8643 8644 8645 8646 8647 8648 8650 8651 8652 8653 8654 8656 8658 8667 8668 8669 8670 8672 8673 8674 8675 8676 8677 8678 8679 8680 8681 8682 8683 8684 8685 8686 8688 8689 8691 8692 8693 8694 8695 8697 8698 8699 8700 8702 8703 8704 8707 8708 8709 8710 8711 8712 8713 8714 8715 8716 8717 8720 8721 8722 8723 8724 8725 8726 8727 8728 8730 8731 6046 6047 6048 6049 6050 6051 6052 6053 6054 6055 6056 6057 6058 6059 6060 6061
}
arid = { # 447
	346 347 349 350 351 352 353 355 365 383 384 385 386 387 388 389 390 391 392 393 394 395 396 397 398 400 403 404 405 432 433 434 435 436 437 438 439 443 447 448 451 455 503 512 513 514 575 576 577 578 698 701 702 706 707 708 709 710 711 712 713 715 720 739 774 780 781 792 793 796 805 806 809 812 862 863 865 866 867 875 876 877 878 1111 1112 1115 1127 1128 1129 1130 1131 1132 1133 1148 1156 1157 1158 1159 1173 1174 1175 1193 1203 1204 1205 1206 1207 1208 1209 1212 1215 1219 1220 1221 1226 1228 1229 1230 1231 1232 1233 1234 1273 1779 1784 1785 1786 1790 1791 1793 1794 1795 1801 1808 1925 1970 2024 2064 2066 2068 2072 2078 2079 2086 2088 2121 2122 2123 2124 2191 2192 2193 2200 2220 2222 2224 2225 2226 2229 2230 2231 2232 2233 2234 2243 2244 2246 2247 2259 2260 2261 2262 2263 2264 2265 2268 2269 2271 2272 2273 2274 2275 2276 2277 2279 2282 2284 2287 2288 2315 2318 2320 2321 2322 2323 2324 2325 2326 2327 2328 2329 2330 2331 2332 2333 2334 2335 2336 2337 2338 2339 2340 2341 2342 2343 2344 2345 2346 2347 2349 2350 2362 2363 2370 2448 2449 2450 2451 2452 2456 2457 2458 2460 2463 2466 2472 2474 2475 2478 2491 2492 2493 2498 2616 2620 2747 2764 2765 2766 2767 2768 2773 2774 2775 2776 2777 2778 2779 2780 2781 2782 2783 2784 2785 2786 2788 2789 2790 2792 2793 2794 2795 2796 2797 2801 2802 2821 2822 2826 2828 2840 2841 2844 2847 2863 2867 2868 2869 2870 2875 2876 2932 2954 4028 4032 4051 4052 4055 4056 4057 4073 4204 4206 4207 4209 4210 4223 4268 4269 4270 4272 4273 4274 4275 4276 4277 4278 4279 4280 4281 4282 4284 4285 4286 4287 4321 4322 4323 4502 4503 4504 4505 4506 4507 4508 4509 4513 4567 4577 4628 4633 4644 4650 4670 4676 4677 4693 4955 4964 4966 4967 4975 4979 5016 5042 5043 5044 5061 5181 5203 5221 5222 5223 5228 5231 5232 5233 5235 5239 5241 5243 5244 5246 5249 5250 5251 5256 5266 5271 5272 5273 5274 5277 5278 5279 5280 5281 5282 5283 5284 5286 5288 5298 5300 5301 5302 5303 5304 5306 5307 5309 5310 5311 5312 5316 5324 5328 5329 5333 5346 5386 5387 5388 5389 5391 5392 5395 5396 5397 5408 5409 5424 5425 5426 5769 5770 5771 5772 5773 5791 5815 5821 5822 5823 5832 5835 5838 5839 5840 5841 5843 5858 5860 5861 5862 6065 6066 6068 6069 6081 6082 6085 6088 6097 6098
}
arctic = { # 231
	305 315 371 676 677 705 997 998 999 1005 1006 1034 1035 1036 1037 1038 1039 1040 1041 1042 1043 1044 1045 1046 1047 1051 1052 1054 1055 1059 1061 1062 1064 1067 1068 1069 1070 1071 1072 1073 1074 1075 1076 1077 1078 1080 1104 1105 1777 1780 1781 1782 1783 1787 1804 1805 1806 1807 1810 1811 1812 1962 1963 1964 2025 2102 2128 2129 2130 2134 2425 2426 2427 2428 2429 2430 2431 2432 2433 2435 2436 2437 2438 2439 2440 2442 2443 2445 2446 2574 2575 2592 2594 2595 2599 3111 3112 3113 3114 3119 3284 3285 4129 4151 4205 4257 4514 4515 4516 4518 4519 4520 4690 4691 4968 4969 4970 4971 4976 4977 4978 4980 4983 4985 4986 4987 4989 4990 4991 4992 4993 4994 4995 4996 4997 4998 4999 5001 5002 5003 5006 5007 5008 5009 5010 5011 5012 5014 5015 5040 5041 5067 5068 5069 5070 5071 5072 5073 5074 5075 5076 5077 5078 5079 5080 5081 5082 5083 5084 5087 5093 5120 5123 5573 5580 5587 5588 5589 5590 5591 5592 5593 5594 5595 5596 5639 5641 5650 5673 5674 5675 5676 5677 5678 5722 5899 5911 5912 5913 5914 5915 5916 5917 5918 5919 5923 5924 5925 5928 5929 5930 5931 5932 5933 5934 5935 5937 8000 8001 8002 8003 8004 8005 8006 8007 8008 8009 8010 8011 8012 8545 
}
mild_winter = { # 988
	6 12 13 14 15 26 44 45 46 47 54 55 87 88 89 90 91 92 93 94 95 96 97 98 99 100 104 107 108 109 111 112 113 114 119 131 138 139 140 141 143 144 150 159 160 161 167 168 169 170 171 172 173 174 175 177 178 179 180 181 182 183 184 185 186 187 188 189 190 191 192 193 194 195 196 198 199 203 207 208 209 210 211 214 215 216 217 219 223 228 232 233 234 235 236 237 238 239 240 241 243 244 249 282 283 284 285 286 287 322 325 328 330 372 373 374 375 376 411 413 415 416 417 418 421 424 425 426 427 428 429 432 433 434 435 436 437 438 439 440 441 442 443 446 447 454 455 456 457 463 464 468 508 509 511 576 577 678 689 690 691 692 693 694 695 696 697 698 699 700 701 703 704 707 708 709 710 711 712 713 715 726 739 780 781 794 795 797 804 807 871 872 873 874 881 882 885 889 890 891 892 896 897 918 934 935 936 937 938 939 940 941 950 972 973 974 975 1012 1014 1017 1018 1019 1020 1021 1023 1024 1025 1026 1027 1028 1029 1030 1742 1743 1744 1745 1746 1747 1748 1756 1764 1765 1766 1767 1769 1774 1775 1786 1816 1818 1819 1820 1825 1826 1827 1828 1830 1831 1832 1835 1837 1839 1843 1846 1853 1857 1860 1861 1862 1865 1866 1874 1877 1878 1879 1931 1954 1969 1970 1973 1974 1981 1982 1983 1984 2022 2069 2077 2078 2112 2113 2120 2121 2122 2123 2124 2131 2132 2133 2135 2136 2137 2138 2139 2169 2170 2177 2178 2179 2180 2181 2182 2183 2184 2192 2195 2199 2206 2207 2208 2210 2211 2212 2213 2214 2215 2216 2217 2218 2220 2221 2222 2223 2224 2229 2230 2232 2234 2236 2297 2299 2304 2308 2349 2350 2356 2362 2363 2370 2406 2410 2411 2412 2413 2414 2416 2417 2447 2462 2464 2468 2477 2478 2481 2484 2485 2491 2492 2515 2527 2544 2545 2546 2547 2548 2609 2610 2741 2745 2746 2750 2751 2754 2755 2829 2831 2836 2837 2838 2844 2861 2863 2865 2867 2940 2942 2946 2947 2973 2974 2975 2977 2989 2990 2991 2996 2998 3000 3001 3005 3006 3008 3009 3014 3019 3028 3036 3058 3060 3063 3064 3066 3068 3070 3071 3073 3075 3077 3081 3083 3087 3089 3091 3092 3095 3099 3110 3134 3135 3160 3164 3165 3167 3168 3169 3174 3183 3185 3187 3190 3194 3196 3243 3244 3245 3248 3261 3263 3264 3302 4111 4112 4118 4119 4120 4121 4130 4131 4141 4142 4149 4165 4168 4171 4175 4176 4180 4181 4182 4183 4184 4185 4186 4187 4188 4189 4190 4191 4192 4194 4195 4198 4206 4207 4208 4209 4210 4211 4223 4227 4228 4239 4292 4293 4294 4295 4298 4300 4308 4311 4312 4324 4325 4326 4329 4330 4331 4334 4335 4336 4337 4338 4339 4340 4341 4342 4343 4344 4345 4359 4360 4362 4365 4369 4370 4371 4372 4373 4374 4375 4376 4377 4378 4379 4380 4381 4382 4383 4384 4385 4386 4387 4388 4389 4390 4391 4392 4531 4547 4549 4551 4552 4553 4554 4557 4558 4568 4652 4672 4675 4693 4695 4697 4702 4703 4704 4706 4719 4728 4729 4733 4739 4740 4745 4750 4752 4756 4757 4764 4766 4768 4769 4770 4776 4777 4780 4788 4789 4942 4955 4966 5031 5042 5045 5130 5152 5163 5172 5206 5295 5320 5324 5325 5326 5327 5366 5518 5519 5731 5732 5733 5734 5735 5736 5739 5747 5748 5749 5750 5755 5759 5760 5761 5763 5771 5772 5773 5775 5780 5781 5797 5799 5801 5802 5804 5805 5807 5809 5810 5811 5821 5822 5823 5832 5847 5848 5849 5851 5853 5854 5867 5868 5869 5870 5871 5872 5873 5874 5875 5877 5878 5940 5941 6001 6002 6025 6033 6034 6035 6041 7013 7014 7016 7024 7025 7026 7027 7028 7030 7031 7032 7034 7037 7048 7058 7059 7061 7062 7068 7076 7078 7081 7082 7085 7086 7087 7096 7123 7124 7126 7128 7133 7141 7142 7144 7146 7147 7148 7149 7150 7151 7152 7154 7155 7156 7157 7158 7159 7190 7191 7192 7193 7194 7195 7200 7201 7202 7203 7204 7278 7702 7703 7705 7706 7707 7711 7714 7715 7717 7718 7721 7723 7724 7725 7727 7728 7729 7733 7734 7736 7738 7739 7740 7748 7750 7752 7753 7754 7755 7756 7757 7758 7759 7761 7762 7765 7766 7767 7768 7769 7770 7771 7773 7774 7775 7776 7777 7778 7779 7842 7897 7899 7901 7903 7904 7905 7906 7907 7908 7909 7910 7911 7914 7915 7916 7917 7918 7922 7924 7925 7926 7927 7928 7929 7930 7931 7932 7933 7934 7935 7936 7937 7938 7939 7945 7946 7947 7948 7950 7951 7952 7953 7954 7955 7956 7957 7958 7959 7960 7961 7962 7963 7964 7965 7966 7967 7968 7969 7970 7971 7972 7973 7974 7975 7976 7977 7979 7980 7981 7982 7983 7984 7985 7986 7987 7988 7989 7990 7991 7992 7993 7994 7995 7996 7997 7998 7999 8013 8014 8015 8016 8017 8018 8019 8020 8021 8022 8023 8024 8025 8026 8027 8028 8030 8032 8033 8034 8035 8036 8037 8038 8039 8040 8041 8043 8044 8045 8047 8048 8049 8050 8051 8052 8053 8054 8055 8056 8057 8058 8059 8060 8061 8064 8065 8066 8069 8070 8071 8073 8082 8083 8084 8085 8087 8092 8093 8094 8095 8096 8099 8109 8111 8112 8113 8116 8117 8118 8119 8120 8121 8122 8123 8124 8125 8126 8127 8128 8129 8130 8131 8138 8139 8143 8144 8156 8157 8158 8159 8160 8161 8162 8163 8164 8165 8166 8167 8168 8169 8170 8187 8217 8296 8297 8298 8299 8400 8401 8402 8403 8404 8419 8420 8421 8422 8423 4908 4923 4887 4921 4913 4932 4931 4878 4879 4886
}
normal_winter = { # 1018
	1 2 3 4 5 7 16 17 23 24 25 27 28 35 36 37 38 39 40 41 42 43 48 49 50 51 52 53 56 57 58 59 60 61 62 63 64 65 66 67 68 69 70 71 72 74 75 76 77 78 79 80 81 82 83 84 85 86 103 105 106 110 120 128 129 132 133 134 135 152 153 154 155 156 157 158 162 176 204 205 242 245 246 247 248 250 251 252 253 254 255 256 257 258 259 260 261 262 263 264 265 266 267 268 269 270 271 272 273 274 275 276 277 278 279 280 281 288 289 290 291 292 323 324 326 329 331 332 369 414 419 420 423 444 445 448 449 450 451 453 459 461 465 466 469 470 471 472 474 476 477 478 479 578 702 705 706 714 720 722 723 730 732 733 734 735 736 737 767 770 771 782 783 785 791 875 878 879 880 898 899 900 901 902 915 916 917 942 943 944 946 947 948 949 951 952 953 954 955 956 957 958 959 960 961 962 963 964 965 966 967 968 969 970 976 979 987 988 1013 1031 1032 1033 1095 1318 1757 1758 1759 1760 1761 1762 1763 1770 1771 1772 1808 1834 1841 1842 1845 1847 1848 1850 1852 1858 1859 1863 1864 1867 1868 1869 1872 1875 1876 1880 1930 1935 1936 1937 1938 1939 1940 1941 1942 1943 1944 1945 1951 1952 1953 1960 1966 1967 1968 1971 1978 1979 1985 2010 2011 2019 2020 2023 2106 2108 2109 2110 2111 2114 2115 2118 2119 2125 2126 2134 2187 2188 2191 2193 2196 2202 2204 2205 2225 2226 2227 2228 2235 2300 2301 2303 2305 2306 2307 2351 2352 2353 2354 2355 2357 2358 2359 2360 2361 2364 2365 2366 2367 2368 2369 2405 2407 2409 2424 2479 2480 2483 2487 2488 2489 2490 2493 2494 2495 2496 2507 2508 2509 2513 2514 2519 2520 2523 2524 2525 2526 2549 2550 2551 2552 2553 2554 2555 2556 2557 2558 2560 2561 2562 2605 2607 2611 2613 2625 2639 2670 2672 2694 2742 2743 2744 2747 2752 2843 2845 2847 2869 2870 2871 2872 2873 2874 2875 2876 2877 2955 2956 2957 2958 2959 2960 2961 2962 2963 2964 2965 2966 2967 2968 2969 2970 2971 2972 2979 2981 2987 2993 2994 2995 2997 3002 3034 3046 3048 3050 3051 3054 3055 3120 3121 3122 3123 3137 3138 3139 3142 3146 3148 3151 3152 3154 3156 3157 3159 3193 3198 3199 3200 3201 3202 3203 3204 3206 3207 3209 3214 3220 3221 3223 3224 3225 3226 3227 3229 3230 3231 3238 3239 3241 3242 3246 3247 3253 3254 3256 3265 3266 3267 3270 3292 3293 3297 4110 4115 4125 4126 4127 4128 4143 4144 4163 4164 4166 4167 4173 4179 4193 4200 4201 4202 4203 4204 4221 4229 4230 4231 4232 4236 4237 4238 4240 4241 4242 4246 4247 4296 4299 4302 4304 4307 4310 4313 4314 4361 4363 4364 4366 4367 4368 4514 4515 4516 4518 4519 4520 4522 4523 4524 4525 4526 4527 4528 4529 4530 4532 4533 4534 4535 4536 4537 4538 4539 4540 4541 4542 4543 4544 4545 4569 4630 4631 4632 4634 4653 4661 4669 4670 4671 4674 4676 4677 4682 4683 4684 4685 4686 4692 4694 4707 4708 4709 4711 4712 4713 4714 4715 4716 4717 4718 4720 4723 4724 4725 4726 4727 4730 4741 4742 4743 4744 4746 4747 4748 4749 4751 4755 4759 4760 4761 4762 4765 4767 4771 4772 4773 4774 4775 4778 4785 4786 4945 4946 4952 4953 4954 4956 4957 4958 4959 4961 4962 4963 4965 4967 4974 4975 4979 5013 5016 5017 5019 5021 5044 5058 5059 5064 5065 5094 5097 5129 5137 5146 5150 5154 5155 5158 5164 5167 5330 5331 5332 5642 5643 5644 5645 5660 5725 5727 5728 5729 5737 5738 5742 5743 5744 5745 5751 5752 5753 5754 5756 5757 5762 5768 5769 5770 5782 5793 5796 5798 5800 5803 5812 5813 5815 5819 5820 5824 5826 5827 5830 5833 5834 5835 5836 5838 5845 5850 5863 5864 5866 5876 5879 5881 5882 5883 5885 5888 5904 5905 5906 5907 5920 6014 6018 6019 6020 6021 6027 6028 6029 6037 6038 6040 7015 7045 7052 7057 7060 7063 7064 7065 7066 7067 7070 7072 7075 7079 7080 7083 7084 7089 7091 7094 7098 7196 7197 7198 7199 7205 7206 7207 7208 7209 7210 7211 7212 7213 7214 7215 7216 7217 7218 7219 7220 7221 7222 7223 7224 7225 7226 7227 7228 7229 7230 7231 7232 7233 7234 7235 7236 7237 7238 7239 7240 7241 7242 7243 7244 7245 7246 7248 7249 7250 7251 7252 7253 7254 7255 7256 7257 7258 7259 7262 7263 7264 7266 7267 7268 7269 7270 7271 7272 7273 7274 7275 7276 7277 7279 7700 7701 7709 7710 7712 7722 7741 7743 7744 7745 7746 7749 7751 7760 7764 7772 7780 7781 7782 7790 7791 7792 7793 7794 7795 7809 7810 7811 7812 7813 7815 7816 7817 7818 7819 7821 7823 7824 7825 7826 7827 7828 7829 7830 7831 7832 7833 7834 7835 7836 7837 7838 7839 7840 7841 7843 7844 7845 7846 7847 7848 7849 7850 7851 7852 7853 7854 7855 7856 7857 7858 7859 7860 7861 7862 7872 7892 7896 7919 7920 7921 7923 7940 7942 7944 7949 8029 8108 8110 8133 8134 8135 8136 8137 8140 8141 8142 8145 8146 8147 8148 8149 8150 8151 8152 8153 8154 8155 8171 8172 8173 8174 8175 8176 8177 8178 8179 8180 8181 8182 8183 8184 8185 8186 8188 8189 8190 8191 8192 8193 8194 8195 8196 8197 8198 8199 8200 8201 8202 8203 8204 8205 8206 8207 8208 8209 8210 8211 8212 8213 8214 8215 8216 8218 8219 8220 8221 8222 8223 8224 8225 8226 8227 8228 8229 8230 8231 8232 8233 8234 8236 8237 8238 8239 8240 8241 8243 8244 8245 8246 8247 8248 8249 8251 8252 8253 8254 8255 8256 8257 8258 8259 8260 8262 8263 8264 8265 8266 8267 8268 8269 8270 8271 8272 8273 8274 8275 8276 8277 8278 8279 8280 8281 8282 8283 8284 8285 8286 8287 8288 8289 8290 8291 8292 8293 8294 8295 8405 8406 8407 8408 8409 8410 8411 8412 8413 8414 8415 8416 8417 8418 8424 8425 8426 8427 8428 8429 8430 8431 8432 8433 8434 8435 8436 8437 8438 8439 8440 8441 8442 8443 8444 8445 8446 8447 8448 8449 8450 8451 8452 8453 8454 8455 8456 8457 8458 8459 8460 8461 8464 8466 8467 8468 8469 8470 8471 8472 8473 8474 8475 8476 8477 8478 8479 8480 8486 8487 8488 8489 8490 8493 8494 8495 165 1870 4721 4915 4914 4904 4906 4905 4903 4922 4907 4888 4930 4889 4933 4877 4929 4928 4875 4872 4876 4927 4874
}
severe_winter = { # 824
	8 9 10 11 18 19 20 21 22 29 30 31 32 33 34 73 166 293 294 295 296 297 298 299 300 301 302 303 304 305 306 307 308 309 310 311 312 313 314 315 370 371 422 452 458 460 462 467 473 475 480 554 557 565 676 677 716 717 718 719 721 724 725 727 728 729 731 903 904 905 906 907 908 909 910 911 912 913 914 945 971 977 978 980 981 982 983 984 985 986 989 990 991 992 993 994 995 996 997 998 999 1000 1001 1002 1003 1004 1005 1006 1007 1008 1009 1010 1011 1034 1035 1036 1037 1038 1039 1040 1041 1042 1043 1044 1045 1046 1047 1048 1049 1050 1051 1052 1053 1054 1055 1056 1057 1058 1059 1060 1061 1062 1063 1064 1065 1066 1067 1068 1069 1070 1071 1072 1073 1074 1075 1076 1077 1078 1079 1080 1081 1082 1083 1104 1105 1752 1753 1754 1755 1768 1776 1777 1778 1780 1781 1782 1783 1784 1785 1787 1788 1804 1805 1806 1807 1809 1810 1811 1812 1813 1814 1856 1871 1873 1913 1955 1956 1957 1958 1959 1961 1962 1963 1964 1965 1972 2003 2004 2005 2006 2007 2008 2009 2012 2013 2015 2016 2017 2018 2025 2070 2071 2073 2074 2102 2103 2104 2105 2107 2116 2117 2127 2128 2129 2130 2185 2186 2189 2190 2194 2197 2198 2200 2201 2203 2408 2415 2418 2419 2420 2421 2422 2423 2425 2426 2427 2428 2429 2430 2431 2432 2433 2434 2435 2436 2437 2438 2439 2440 2441 2442 2443 2444 2445 2446 2482 2486 2501 2502 2503 2504 2505 2506 2510 2511 2512 2517 2518 2521 2522 2559 2563 2564 2565 2566 2567 2568 2569 2570 2571 2572 2573 2574 2575 2576 2577 2578 2579 2580 2581 2582 2583 2584 2585 2586 2587 2588 2589 2590 2591 2592 2593 2594 2595 2596 2597 2598 2599 2600 2601 2602 2603 2604 2606 2608 2612 2671 2749 3045 3111 3112 3113 3114 3115 3117 3118 3119 3124 3128 3250 3251 3262 3268 3271 3273 3276 3277 3278 3279 3280 3281 3282 3284 3285 3290 3291 3294 3301 4113 4114 4116 4117 4122 4123 4124 4129 4145 4146 4147 4148 4151 4152 4154 4156 4157 4159 4160 4161 4162 4205 4214 4215 4216 4217 4218 4219 4220 4222 4243 4244 4245 4248 4249 4250 4251 4252 4253 4254 4255 4256 4257 4258 4259 4260 4261 4262 4263 4264 4265 4266 4267 4301 4303 4305 4306 4315 4481 4482 4517 4521 4654 4655 4656 4658 4659 4660 4662 4663 4664 4665 4666 4667 4668 4673 4678 4679 4680 4681 4687 4688 4689 4690 4691 4710 4722 4758 4763 4943 4944 4947 4948 4949 4960 4968 4969 4970 4971 4972 4973 4976 4977 4978 4980 4981 4982 4983 4984 4985 4986 4987 4988 4989 4990 4991 4992 4993 4994 4995 4996 4997 4998 4999 5000 5001 5002 5003 5004 5005 5006 5007 5008 5009 5010 5011 5012 5014 5015 5033 5034 5035 5036 5037 5038 5039 5040 5041 5046 5047 5048 5049 5050 5051 5052 5053 5054 5055 5056 5057 5060 5066 5067 5068 5069 5070 5071 5072 5073 5074 5075 5076 5077 5078 5079 5080 5081 5082 5083 5084 5085 5086 5087 5088 5089 5093 5095 5111 5112 5116 5117 5118 5120 5121 5123 5124 5125 5126 5127 5151 5507 5508 5509 5510 5511 5512 5513 5514 5515 5516 5517 5523 5524 5525 5526 5527 5528 5529 5530 5531 5532 5533 5534 5535 5536 5537 5538 5540 5541 5542 5543 5544 5545 5546 5547 5548 5573 5580 5587 5588 5589 5590 5591 5592 5593 5594 5595 5596 5611 5612 5613 5614 5615 5616 5617 5618 5619 5620 5621 5622 5623 5624 5625 5626 5627 5628 5629 5630 5631 5632 5633 5634 5635 5636 5637 5638 5639 5640 5641 5646 5647 5648 5649 5650 5651 5652 5653 5654 5655 5656 5657 5658 5659 5661 5662 5663 5664 5665 5666 5667 5668 5669 5670 5671 5672 5673 5674 5675 5676 5677 5678 5679 5680 5681 5682 5683 5684 5685 5722 5723 5724 5726 5730 5740 5741 5746 5758 5776 5777 5778 5779 5783 5784 5785 5786 5787 5788 5789 5790 5806 5808 5816 5825 5837 5846 5880 5884 5886 5887 5889 5890 5891 5892 5893 5894 5895 5896 5897 5898 5899 5900 5901 5902 5903 5908 5909 5910 5911 5912 5913 5914 5915 5916 5917 5918 5919 5921 5922 5923 5924 5925 5926 5927 5928 5929 5930 5931 5932 5933 5934 5935 5936 5937 5938 5939 7071 7088 7093 7747 7783 7784 7785 7786 7787 7788 7789 7796 7797 7798 7799 7800 7801 7802 7803 7804 7805 7806 7807 7808 7863 7864 7865 7866 7867 7868 7869 7870 7871 7873 7874 7875 7876 7877 7878 7879 7880 7881 7882 7889 7895 7913 8000 8001 8002 8003 8004 8005 8006 8007 8008 8009 8010 8011 8012 8031 8545 8462 8463 8465 8481 8482 8483 8484 8485 8491 8492 4871 4873 4891 4894 4895 4896 4897 4898 4899 4900 4901 4902 4916 4917 4918 4919 4924 4925 4926 4912
}
impassable = { # 120 + 31
	# used wasteland / 120
	# see: wasteland_area
	1173 1779 1781 1782 1783 1784 1785 1786 1787 1788 1789 1790 1791 1793 1794 1795 1796 1797 1798 1799 1801 1802 1803 1804 1807 1814 1913 1950 2129 2194 2200 2251 2334 2426 2740 2936 4146 4154 4156 4157 4159 4160 4161 4162 4167 4168 4400 4401 4402 4403 4522 4569 4763 4807 4843 4924 4925 4926 4927 4928 4929 4930 4931 4932 4933 5111 5112 5116 5117 5118 5120 5121 5123 5124 5125 5126 5127 5129 5507 5508 5509 5510 5511 5512 5513 5514 5515 5516 5517 5518 5519 5520 5521 5522 5523 5524 5525 5526 5527 5528 5529 5530 5531 5532 5533 5534 5535 5536 5537 5538 5539 5540 5541 5542 5543 5544 5545 5546 5547 5548 5549 5550 5551 5552 5553 5554 5555 5556 5557 5558 5559 5560 6097 6098 8608 8609 
	# BT does NOT support RNW
	# a list of provinces, because... / 31
	# see: unused_wasteland_area and only_used_for_random
	3427 3437 3590 3591 3592 3593 3594 3595 3596 3597 3598 3599 3621 3622 3623 3624 3625 3626 3628 3629 3630 3631 3632 3633 3634 3635 3636 3638 3639 8550 8570 6146 6147 6148
}
mild_monsoon = { # 289
	507 510 515 518 521 527 532 533 538 539 540 541 542 544 545 569 574 580 583 585 586 587 588 589 600 601 602 603 605 609 617 652 653 671 682 685 686 749 758 765 766 768 769 1014 1017 1019 1025 1026 1098 1113 1116 1120 1121 1123 1124 1134 1135 1136 1137 1142 1148 1149 1150 1154 1155 1157 1158 1159 1160 1167 1168 1171 1172 1200 1202 1203 1817 1818 1821 1822 1825 1845 1947 1948 1949 2026 2027 2031 2033 2035 2037 2052 2058 2065 2075 2076 2083 2085 2087 2090 2100 2145 2146 2147 2172 2174 2245 2248 2249 2250 2265 2266 2270 2278 2279 2280 2281 2282 2283 2284 2286 2287 2288 2293 2376 2378 2388 2389 2397 2398 2400 2401 2673 2730 2731 2857 2879 2884 2888 2893 2894 2895 2896 2897 2899 2900 2901 2902 2904 2905 2906 2907 2908 2909 2910 2911 2919 2920 2927 2928 2948 4028 4030 4034 4035 4036 4037 4038 4039 4040 4042 4043 4048 4055 4056 4057 4058 4059 4061 4063 4070 4071 4072 4073 4076 4077 4080 4082 4083 4084 4087 4091 4092 4093 4094 4095 4097 4099 4104 4105 4106 4107 4108 4109 4131 4182 4184 4192 4197 4354 4393 4394 4395 4396 4397 4398 4399 4406 4407 4408 4409 4411 4414 4415 4416 4417 4418 4419 4420 4421 4422 4423 4424 4426 4428 4432 4433 4434 4435 4436 4437 4439 4453 4454 4455 4462 4463 4501 4510 4513 4808 4830 4831 4832 4833 4834 4835 4836 4837 4841 4842 4843 4844 5028 8548 8549 8552 8553 8554 8555 8569 8576 8581 8600 8618 8636 8639 8640 8641 8642 8662 8676 8677 8678 8679 8688 8689 8714 8715 581 584 2399 8551 8644 8645 660 2166 612 2385 2384 2386 8572 4827 8683 8684 8685 4865 2726 4864 4849 2732 2733 4850 1094 4851 4854 1092
}
normal_monsoon = { # 454
	508 516 519 520 522 523 524 525 526 528 534 535 537 543 549 552 555 556 558 560 572 582 595 596 604 604 606 607 608 610 611 613 614 615 616 618 619 620 627 628 630 631 632 633 635 638 643 644 645 648 649 650 651 654 655 656 657 658 659 665 666 667 668 669 670 683 684 733 734 735 736 737 738 740 747 748 761 762 763 764 788 798 1012 1013 1015 1016 1018 1020 1021 1022 1023 1024 1027 1028 1029 1030 1100 1101 1102 1103 1122 1125 1126 1138 1139 1140 1141 1143 1144 1145 1146 1152 1153 1161 1162 1166 1169 1170 1183 1184 1186 1192 1193 1194 1195 1196 1197 1198 1199 1201 1235 1236 1237 1248 1249 1273 1792 1819 1820 1823 1824 1829 1830 1832 1833 1835 1837 1839 1843 1844 1901 1925 1946 1991 1992 1993 1994 1995 1996 1998 1999 2028 2034 2038 2043 2047 2049 2051 2053 2054 2055 2056 2057 2060 2061 2062 2063 2064 2080 2084 2093 2094 2095 2096 2099 2148 2149 2150 2151 2152 2153 2154 2155 2156 2157 2158 2159 2160 2161 2162 2164 2239 2252 2253 2254 2255 2256 2257 2258 2267 2285 2291 2292 2295 2371 2372 2373 2374 2375 2377 2379 2380 2381 2382 2392 2395 2396 2674 2675 2676 2677 2685 2688 2691 2692 2693 2694 2695 2696 2697 2698 2699 2700 2701 2702 2709 2710 2711 2712 2713 2714 2717 2719 2720 2721 2722 2725 2728 2729 2741 2745 2887 2888 2889 2890 2903 2904 2905 2929 2930 2933 2934 2935 2938 2949 2950 2951 2952 4020 4022 4023 4027 4031 4032 4041 4044 4045 4049 4053 4054 4060 4062 4064 4065 4066 4067 4068 4069 4074 4075 4078 4079 4081 4085 4086 4088 4089 4090 4096 4098 4100 4101 4102 4103 4180 4181 4183 4185 4186 4187 4188 4189 4190 4191 4227 4228 4229 4230 4231 4348 4349 4350 4351 4352 4353 4355 4356 4359 4360 4404 4405 4410 4413 4425 4431 4438 4441 4444 4449 4450 4456 4457 4461 4464 4465 4469 4470 4471 4472 4480 4484 4487 4488 4489 4490 4494 4495 4496 4497 4498 4499 4500 4512 4791 4794 4799 4809 4810 4811 4813 4819 4820 4821 4822 4824 4828 4829 4838 4840 8544 8547 8573 8580 8592 8593 8597 8598 8602 8603 8604 8606 8608 8609 8610 8622 8623 8624 8625 8627 8630 8631 8633 8634 8635 8646 8647 8648 8652 8653 8654 8656 8658 8660 8661 8663 8664 8665 8666 8667 8668 8669 8670 8691 8704 8707 8708 8709 8710 8711 8712 8713 8716 8717 8720 8721 8722 8723 8724 8725 8726 8727 8728 8730 8731 4823 8682 4839 8587 2383 4847 4846 4867 4866 2677 4816
}
severe_monsoon = { # 222
	509 511 517 529 530 531 546 547 548 550 551 553 554 557 559 561 562 563 564 566 567 568 570 571 573 579 590 591 592 593 594 597 598 599 621 622 623 624 625 626 629 634 636 637 639 640 641 642 646 647 1097 1114 1117 1118 1119 1147 1151 1163 1164 1165 1245 1306 1787 1789 1815 1950 2029 2030 2032 2036 2039 2040 2041 2042 2044 2045 2046 2048 2050 2059 2069 2070 2071 2081 2082 2089 2091 2092 2097 2098 2238 2241 2242 2251 2289 2290 2294 2387 2390 2391 2393 2394 2402 2403 2404 2678 2679 2680 2681 2682 2683 2684 2686 2687 2689 2690 2703 2704 2705 2706 2707 2708 2715 2716 2718 2723 2724 2740 4021 4024 4025 4026 4029 4400 4401 4427 4429 4430 4440 4442 4443 4445 4446 4447 4448 4451 4452 4458 4459 4460 4466 4467 4468 4473 4474 4475 4476 4477 4478 4479 4483 4485 4486 4491 4492 4493 4790 4793 4795 4796 4797 4798 4800 4801 4802 4803 4804 4805 4806 4807 4812 4814 4815 4817 4818 4825 4826 4845 8546 8559 8561 8565 8571 8577 8578 8584 8585 8614 8615 8616 8619 8632 8643 8650 8651 8672 8673 8674 8675 8680 8681 8686 8692 8693 8694 8695 8697 8698 8699 8700 8702 8703 4792
}
equator_y_on_province_image = 656